2 13 31
###############################
#    *   *    * 2 *  * * *   x#
# # # #*# # #*#*# # # #*#*#*# #
#   *     ***  *  1   * 2 * * #
# # # #*# #*# # #*#*# # # # #*#
#        f   **     *   1     #
# # # # # # # # # #*# #*# # # #
#*  * 2    ****      *        #
# # # # #*# # # #*#*# # # # # #
#*   *   1        *    s      #
# # # #*# # #*# #*# # # # # # #
#p  b       *   *  *   2      #
###############################